id,health,decline,bed,ventilator,oxygen,total
8,45,-65,5,30,0,15
5,33,-30,5,30,0,38
10,95,-88,5,30,0,42
9,100,-79,5,30,0,56
4,55,-25,5,30,0,65
7,90,-60,5,30,0,65
6,89,-50,5,30,0,74
3,65,-7,5,30,0,93
1,100,-1,5,0,0,104
2,75,-1,5,30,0,109
